type octile
height 50
width 182
map
@@@@@@@@@@@@@@@@@@@@@@@@@@@@@@@@@@@@@@@@@@@@@@@@@@@@@@@@@@@@@@@@@@@@@@@@@@@@@@@@@@@@@@@@@@@@@@@@@@@@@TTTT@@@@@@@@@@@@@@@@@@@@@@@@@@@@@@@@@@@@@@@@@@@@@@@@@@@@@@@@@@@@@@@@@@@@@@@@@@@@@
TTTTTTTTTTTTTTTTTTTTTTTTTTTTTTTTTTTTTTTTTTTTTTTTTTTTTTT@@@@TTTTTTTTTT@@@@@@TTTTTTTTTT@@@@@@TTTTTTTTTTTTTT@@@@@@@@@@@@@@TTTTTTTTTTTTTTTTTTTTTTTTTTTTTTTTTTTTTTTTTTTTTTTTTTTTTTT@@@@@@@@
T.....TTT..TTTTT..............TTT.............TTT.....T@@@@TTTTTTTTTT@@@@@@TTTTTTTTTT@@@@@@T........TTTTT@@@@@@@@@@@@@@TTTTTTT......TTTTTTTTTTTTTTTTTTTTTTTTTTTTTTTTTTTTTTTTTT@@@@@@@@
T..........TTTTT......................................T@@@@T...T....T@@@@@@TTTTTTTTTT@@@@@@T........TTTTT@@@@@@@@@@@@@@TTTTTTT......TTTTTTTTTT.......TTTTTTTTT.......TTTTT...T@@@@@@@@
T.....................................................T@TTT.TTTTTT..TTTTTTT.TTTTTTTTTTTTTTTT..........TTT@@@@@@@@@@@@@@T...............TTTT.............TTTT.................T@@@@@@@@
T......TTTT.....TTTT.........TTTT.....................T@TTTTTTTTTTT.TTTTTTTTTTTTTTTTTTTTTTTT..........TTT@@@@@@@@@@@@@@T................TTT..............TTT.................T@@@@@@@@
TTT....TTT......TTTTT........TTTTT....................T@TTTTTT..TTT.TTTTTTT.TTT.....TTTTTTTT............T@@@@@@@@@@@@@@T.....................................................T@@@@@@@@
TTT..............TTTT........TTTTT............TTT.....T@TTTT.....TT...TTT..............TTT..............T@@@@@@@@@@@@@@T.....................................................T@@@@@@@@
TTT..............TTT.........TTTTT............TTT....TTTTTTT..........TTT...........TT.TTT..............T@@@@@@@@@@@@@@T.....................................................T@@@@@@@@
TTT..............TTT.........TTTTT............TTT....TTTTTTT..........TTT.........TTTT.TTT..............T@@@@@@@@@@@@@@T.....................................................T@@@@@@@@
TTT..............TTT.........TTTTT...................TTTTTTT..........TTT.........TTTTTTTT..............T@@@@@@@@@@@@@@T.....................................................T@@@@@@@@
TTT..............TTT.........TTTTTT...................TTTTTT.......................TT...................T@@@@@@@@@@@@@@T.....................................................T@@@@@@@@
T................TTTTT.......TTTTTT...................TTTTTT............................................T@@@@@@@@@@@@@@T................TTT..................................T@@@@@@@@
T................TTTTT........TTT.....................TTTTTT............................................T@@@@@@@@@@@@@@T...............TTTT..................................T@@@@@@@@
T......TTTTT.....TTT..........TTT.....................TTTTT.............................................T@@@@@@@@@@@@@@TTTTTT........TTTTTT..................................T@@@@@@@@
T......TTTTT.....TTTTT........TTT....................TTTTTT...........................................TTT@@@@@@@@@@@@@@TTTTTTT......TTTTTTT.................................TT@@@@@@@@
TTT..............TTTTT........TTT....................TTTTTT...........................................TTTTT..TTT@@@@@@@TTTTTTT......TTTTTTT.................................TT@@@@@@@@
TTT.TTTTTTTT.....TTTTT........TTT....................TTTTTT............................................TTTTTTTTTTTTTTTTTTTTTTT......TTTTTTT.................................TTTTTT.TTT
TTT.TTTTTTTT.....TTTTT........TTT.....................TTTTT..............................................TTTTTTTTTTTTTTT.....................................................TTTTTTTTT
T...TTTTTTTT.....TTT..........TTT.....................TTTTT...............................................TTTTTTTTTTTT.........................................................TTTTTTT
T...TTTTT.............................................TTTTT.................................................TTTTTTTT.............................................................TTTTT
T...TTTTT.............................................TTT.......................................................TTT...............................................................TTTT
T...TTTTT.............................................TTT...........................................................................................................................TT
T..TTTTTT...........................................................................................................................................................................TT
T..TTTTTT...........................................................................................................................................................................TT
T..TTTTTT...........................................................................................................................................................................TT
T...TTTTT.............................................TTT...........................................................................................................................TT
T...TTTTT.............................................TTT...........................................................................................................................TT
T...TTTTT.TT..........................................TTTTT..................................................TTT....................................................................TT
T...TTTTTTTTT....TTT..........TTTT....................TTTTT.................................................TTTTTTTT..............................................................TTTT
TTT.TTTTTTTT.....TTT..........TTTT....................TTTTT...............................................TTTTTTTTTTTT..........................................................TTTTTT
TTT...TTTTTT.....TTT..........TTTTTT.................TTTTTT.............................................TTTTTTTTTTTTTTTT......................................................TTTTTTTT
TTT..............TTT..........TTTTTT.................TTTTTT...........................................TTTTTTTTTTTTTTTTTTTTTTT........TTTTT..................................TTTTTTTTTT
TTT..............TTT..........TTTTT..................TTTTTT...........................................TTT@@@@@@@@@@@@@@TTTTTTT......TTTTTTT.................................TT@@@@@@@@
TTT..............TTT..........TTTTT.T.................TTTTT............................................TT@@@@@@@@@@@@@@TTTTTTT......TTTTTTT.................................TT@@@@@@@@
TTT....TTTTT.....TTT..........TTTTT...................TTTTT.............................................T@@@@@@@@@@@@@@TTTTTTT......TTTTTTT.................................TT@@@@@@@@
TTT....TTTTT.....TTT..........TTTTT...................TTTTT.............................................T@@@@@@@@@@@@@@T...............TTTT..................................T@@@@@@@@
TTT..............TTTTTT.TTTTTTTTTTTTTTTTTTTTTTT.TTTTTTTTTTT.............................................T@@@@@@@@@@@@@@T................TTT..................................T@@@@@@@@
TTT..............TTTTTT.TTTTTTTTTTTTTTTTTTTTTTTTTTTTTTTTTTT...........................TTTT..............T@@@@@@@@@@@@@@T.....................................................T@@@@@@@@
TTTTTTTT@@@@@@@@@@@@@@@@@@@@@@@@@@@@@@@@@@@@@@@TTTTTTTTTTTT...........TTT.............TTTT..............T@@@@@@@@@@@@@@T.....................................................T@@@@@@@@
@@@@@@@@@@@@@@@@@@@@@@@@@@@@@@@@@@@@@@@@@@@@@@@@@@@@@@@TTTT...........TTT.............TTTT..............T@@@@@@@@@@@@@@T.....................................................T@@@@@@@@
@@@@@@@@@@@@@@@@@@@@@@@@@@@@@@@@@@@@@@@@@@@@@@@@@@@@@@@@TTT...........TTT.............TTTT..............T@@@@@@@@@@@@@@T.....................................................T@@@@@@@@
@@@@@@@@@@@@@@@@@@@@@@@@@@@@@@@@@@@@@@@@@@@@@@@@@@@@@@@@TTT...........TTT...TTT..TTT..TTTT..............T@@@@@@@@@@@@@@T.....................................................T@@@@@@@@
@@@@@@@@@@@@@@@@@@@@@@@@@@@@@@@@@@@@@@@@@@@@@@@@@@@@@@@@TTT...........TTT...TTTTTTTT..TTTT............TTT@@@@@@@@@@@@@@T.....................................................T@@@@@@@@
@@@@@@@@@@@@@@@@@@@@@@@@@@@@@@@@@@@@@@@@@@@@@@@@@@@@@@@@TTT...........TTT...TTTTTTTT..TTTT............TTT@@@@@@@@@@@@@@T................................TTT..................T@@@@@@@@
@@@@@@@@@@@@@@@@@@@@@@@@@@@@@@@@@@@@@@@@@@@@@@@@@@@@@@@@@@@..........@@@@@@.TTTTTTTT.@@@@@@...........TTT@@@@@@@@@@@@@@T...............TTTT.............TTTT.................T@@@@@@@@
@@@@@@@@@@@@@@@@@@@@@@@@@@@@@@@@@@@@@@@@@@@@@@@@@@@@@@@@@@@T........T@@@@@@TTTTTTTTTT@@@@@@T........TTTTT@@@@@@@@@@@@@@TTTTTT........TTTTTTTT........TTTTTTTTT........TTTT...T@@@@@@@@
@@@@@@@@@@@@@@@@@@@@@@@@@@@@@@@@@@@@@@@@@@@@@@@@@@@@@@@@@@@TTTTTTTTTT@@@@@@TTTTTTTTTT@@@@@@TTTTTTTTTTTTTT@@@@@@@@@@@@@@TTTTTTT......TTTTTTTTTT.......TTTTTTTTT.......TTTTT...T@@@@@@@@
@@@@@@@@@@@@@@@@@@@@@@@@@@@@@@@@@@@@@@@@@@@@@@@@@@@@@@@@@@@TTTTTTTTTT@@@@@@TTTTTTTTTT@@@@@@TTTTTTTTTTTTTT@@@@@@@@@@@@@@TTTTTTTTTTTTTTTTTTTTTTTTTTTTTTTTTTTTTTTTTTTTTTTTTTTTTTT@@@@@@@@
@@@@@@@@@@@@@@@@@@@@@@@@@@@@@@@@@@@@@@@@@@@@@@@@@@@@@@@@@@@@@@@@@@@@@@@@@@@@@@@@@@@@@@@@@@@@@@@@@@@@@@@@@@@@@@@@@@@@@@@@@@@@@@@@@@@@@@@@@@@@@@@@@@@@@@@@@@@@@@@@@@@@@@@@@@@TTT@@@@@@@@
