type octile
height 11
width 15
map
@@@@@@@@@@@@@@@
@..........@@.@
@@..........@.@
@@...@@.......@
@@...@@.......@
@@........@@..@
@........@@@@.@
@....@....@@..@
@@@..@........@
@@@..@@@......@
@@@@@@@@@@@@@@@
